#@.#######
#..#.....#
#..#..#..#
#..#..#..#
#.....#..#
#######..#
